A	a a
AI	a eh
AN	a nn
ANG	aa ng
AO	aa o
BA	b a a
BAI	b a eh
BAN	b a nn
BANG	b aa ng
BAO	b aa o
BEI	b eh i
BEN	b el nn
BENG	b el ng
BI	bi i i
BIAN	bi a nn
BIAO	bi aa o
BIE	bi eh eh
BIN	bi i nn
BING	bi el ng
BO	bu o o
BU	bu u u
CA	c a a
CAI	c a eh
CAN	c a nn
CANG	c aa ng
CAO	c aa o
CE	c el el
CEN	c el nn
CENG	c el ng
CHA	ch a a
CHAI	ch a eh
CHAN	ch a nn
CHANG	ch aa ng
CHAO	ch aa o
CHE	ch el el
CHEN	ch el nn
CHENG	ch el ng
CHI	ch ib ib
CHONG	chu u ng
CHOU	ch o u
CHU	chu u u
CHUAI	chu a eh
CHUAN	chu a nn
CHUANG	chu aa ng
CHUI	chu eh i
CHUN	chu el nn
CHUO	chu o o
CI	c if if
CONG	cu u ng
COU	c o u
CU	cu u u
CUAN	cu a nn
CUI	cu eh i
CUN	cu el nn
CUO	cu o o
DA	d a a
DAI	d a eh
DAN	d a nn
DANG	d aa ng
DAO	d aa o
DE	d el el
DEI	d eh i
DENG	d el ng
DI	di i i
DIA	di a a
DIAN	di a nn
DIAO	di aa o
DIE	di eh eh
DING	di el ng
DIU	di o u
DONG	du u ng
DOU	d o u
DU	du u u
DUAN	du a nn
DUI	du eh i
DUN	du el nn
DUO	du o o
E	el el
EI	eh i
EN	el nn
ER	er er
FA	f a a
FAN	f a nn
FANG	f aa ng
FEI	f eh i
FEN	f el nn
FENG	f el ng
FO	fu o o
FOU	f o u
FU	fu u u
GA	g a a
GAI	g a eh
GAN	g a nn
GANG	g aa ng
GAO	g aa o
GE	g el el
GEI	g eh i
GEN	g el nn
GENG	g el ng
GONG	gu u ng
GOU	g o u
GU	gu u u
GUA	gu a a
GUAI	gu a eh
GUAN	gu a nn
GUANG	gu aa ng
GUI	gu eh i
GUN	gu el nn
GUO	gu o o
HA	h a a
HAI	h a eh
HAN	h a nn
HANG	h aa ng
HAO	h aa o
HE	h el el
HEI	h eh i
HEN	h el nn
HENG	h el ng
HONG	hu u ng
HOU	h o u
HU	hu u u
HUA	hu a a
HUAI	hu a eh
HUAN	hu a nn
HUANG	hu aa ng
HUI	hu eh i
HUN	hu el nn
HUO	hu o o
JI	ji i i
JIA	ji a a
JIAN	ji a nn
JIANG	ji aa ng
JIAO	ji aa o
JIE	ji eh eh
JIN	ji i nn
JING	ji el ng
JIONG	jv u ng
JIU	ji o u
JU	jv v v
JUAN	jv a nn
JUE	jv eh eh
JUN	jv el nn
KA	k a a
KAI	k a eh
KAN	k a nn
KANG	k aa ng
KAO	k aa o
KE	k el el
KEI	k eh i
KEN	k el nn
KENG	k el ng
KIU	ku o u
KONG	ku u ng
KOU	k o u
KU	ku u u
KUA	ku a a
KUAI	ku a eh
KUAN	ku a nn
KUANG	ku aa ng
KUI	ku eh i
KUN	ku el nn
KUO	ku o o
LA	l a a
LAI	l a eh
LAN	l a nn
LANG	l aa ng
LAO	l aa o
LE	l el el
LEI	l eh i
LENG	l el ng
LI	li i i
LIA	li a a
LIAN	li a nn
LIANG	li aa ng
LIAO	li aa o
LIE	li eh eh
LIN	li i nn
LING	li el ng
LIU	li o u
LONG	lu u ng
LOU	l o u
LU	lu u u
LUAN	lu a nn
LUN	lu el nn
LUO	lu o o
LV	lv v v
LVE	lv eh eh
MA	m a a
MAI	m a eh
MAN	m a nn
MANG	m aa ng
MAO	m aa o
ME	m el el
MEI	m eh i
MEN	m el nn
MENG	m el ng
MI	mi i i
MIAN	mi a nn
MIAO	mi aa o
MIE	mi eh eh
MIN	mi i nn
MING	mi el ng
MIU	mi o u
MO	mu o o
MOU	m o u
MU	mu u u
NA	n a a
NAI	n a eh
NAN	n a nn
NANG	n aa ng
NAO	n aa o
NE	n el el
NEI	n eh i
NEN	n el nn
NENG	n el ng
NI	ni i i
NIAN	ni a nn
NIANG	ni aa ng
NIAO	ni aa o
NIE	ni eh eh
NIN	ni i nn
NING	ni el ng
NIU	ni o u
NONG	nu u ng
NOU	n o u
NU	nu u u
NUAN	nu a nn
NUO	nu o o
NV	nv v v
NVE	nv eh eh
O	o o
OU	o u
PA	p a a
PAI	p a eh
PAN	p a nn
PANG	p aa ng
PAO	p aa o
PEI	p eh i
PEN	p el nn
PENG	p el ng
PI	pi i i
PIAN	pi a nn
PIAO	pi aa o
PIE	pi eh eh
PIN	pi i nn
PING	pi el ng
PO	pu o o
POU	p o u
PU	pu u u
QI	qi i i
QIA	qi a a
QIAN	qi a nn
QIANG	qi aa ng
QIAO	qi aa o
QIE	qi eh eh
QIN	qi i nn
QING	qi el ng
QIONG	qv u ng
QIU	qi o u
QU	qv v v
QUAN	qv a nn
QUE	qv eh eh
QUN	qv el nn
RAN	r a nn
RANG	r aa ng
RAO	r aa o
RE	r el el
REN	r el nn
RENG	r el ng
RI	r ib ib
RONG	ru u ng
ROU	r o u
RU	ru u u
RUAN	ru a nn
RUI	ru eh i
RUN	ru el nn
RUO	ru o o
SA	s a a
SAI	s a eh
SAN	s a nn
SANG	s aa ng
SAO	s aa o
SE	s el el
SEI	s eh i
SEN	s el nn
SENG	s el ng
SHA	sh a a
SHAI	sh a eh
SHAN	sh a nn
SHANG	sh aa ng
SHAO	sh aa o
SHE	sh el el
SHEI	sh eh i
SHEN	sh el nn
SHENG	sh el ng
SHI	sh ib ib
SHOU	sh o u
SHU	shu u u
SHUA	shu a a
SHUAI	shu a eh
SHUAN	shu a nn
SHUANG	shu aa ng
SHUI	shu eh i
SHUN	shu el nn
SHUO	shu o o
SI	s if if
SONG	su u ng
SOU	s o u
SU	su u u
SUAN	su a nn
SUI	su eh i
SUN	su el nn
SUO	su o o
TA	t a a
TAI	t a eh
TAN	t a nn
TANG	t aa ng
TAO	t aa o
TE	t el el
TENG	t el ng
TI	ti i i
TIAN	ti a nn
TIAO	ti aa o
TIE	ti eh eh
TING	ti el ng
TONG	tu u ng
TOU	t o u
TU	tu u u
TUAN	tu a nn
TUI	tu eh i
TUN	tu el nn
TUO	tu o o
WA	wu a a
WAI	wu a eh
WAN	wu a nn
WANG	wu aa ng
WEI	wu eh i
WEN	wu el nn
WENG	wu el ng
WO	wu o o
WU	wu u u
XI	xi i i
XIA	xi a a
XIAN	xi a nn
XIANG	xi aa ng
XIAO	xi aa o
XIE	xi eh eh
XIN	xi i nn
XING	xi el ng
XIONG	xv u ng
XIU	xi o u
XU	xv v v
XUAN	xv a nn
XUE	xv eh eh
XUN	xv el nn
YA	yi a a
YAN	yi a nn
YANG	yi aa ng
YAO	yi aa o
YE	yi eh eh
YI	yi i i
YIN	yi i nn
YING	yi el ng
YO	yi o o
YONG	yi u ng
YOU	yi o u
YU	yv v v
YUAN	yv a nn
YUE	yv eh eh
YUN	yv el nn
ZA	z a a
ZAI	z a eh
ZAN	z a nn
ZANG	z aa ng
ZAO	z aa o
ZE	z el el
ZEI	z eh i
ZEN	z el nn
ZENG	z el ng
ZHA	zh a a
ZHAI	zh a eh
ZHAN	zh a nn
ZHANG	zh aa ng
ZHAO	zh aa o
ZHE	zh el el
ZHEI	zh eh i
ZHEN	zh el nn
ZHENG	zh el ng
ZHI	zh ib ib
ZHONG	zhu u ng
ZHOU	zh o u
ZHU	zhu u u
ZHUA	zhu a a
ZHUAI	zhu a eh
ZHUAN	zhu a nn
ZHUANG	zhu aa ng
ZHUI	zhu eh i
ZHUN	zhu el nn
ZHUO	zhu o o
ZI	z if if
ZONG	zu u ng
ZOU	z o u
ZU	zu u u
ZUAN	zu a nn
ZUI	zu eh i
ZUN	zu el nn
ZUO	zu o o
